-2	16	0	-2	16	0	-2	16	0	-2	16	0	-2	16	0	-2	16	0	-2	16	0	-2	16	0	-2	16	0	-2	16	0	-2	16	0	-2	16	0	-2	16	0	-2	16	0	-2	16	0	-2	16	0	-2	16	0	-2	16	0	-2	16	0	-2	16	0	-2	16	0	-2	16	0	-2	16	0	-2	16	0	-2	16	0	-2	16	0	-2	16	0	-2	16	0	-2	16	0	-2	16	0	-2	16	34	-2	2	72	-2	2	0	-2	2	34	-2	16	72	-2	16	0	-2	16	0	-2	16	0	-2	16	0	-2	16	0
-2	16	0	-2	16	0	-2	16	0	-2	16	0	-2	16	0	-2	16	0	-2	16	0	-2	16	0	-2	16	0	-2	16	0	-2	16	0	-2	16	0	-2	16	0	-2	16	0	-2	16	0	-2	16	0	-2	16	0	-2	16	0	-2	16	0	-2	16	0	-2	16	0	-2	16	0	-2	16	0	-2	16	0	-2	16	0	-2	16	0	-2	16	0	-2	16	0	-2	16	0	-2	16	0	-2	16	50	-2	2	-56	-2	2	0	-2	2	50	-2	16	-56	-2	16	0	-2	16	0	-2	16	0	-2	16	0	-2	16	0
-2	16	0	-2	16	0	-2	16	0	-2	16	0	-2	16	32	-2	16	36	-2	16	68	-2	16	64	-2	16	0	-2	16	0	-2	16	0	-2	16	0	-2	16	0	-2	16	0	-2	16	0	-2	16	0	-2	16	0	-2	16	0	-2	16	0	-2	16	0	-2	16	0	-2	16	0	-2	16	32	-2	16	36	-2	16	68	-2	16	64	-2	16	0	-2	16	0	-2	16	0	-2	16	0	-2	16	50	-2	2	-56	-2	2	0	-2	2	50	-2	16	-56	-2	16	0	-2	16	0	-2	16	0	-2	16	0	-2	16	0
-2	16	0	-2	16	0	-2	16	0	-2	16	0	-2	16	34	-2	18	-39	-2	18	-77	-2	16	72	-2	16	0	-2	16	0	-2	16	0	-2	16	0	-2	16	0	-2	16	0	-2	16	0	-2	16	0	-2	16	0	-2	16	0	-2	16	0	-2	16	0	-2	16	0	-2	16	0	-2	16	34	-2	18	-39	-2	18	-77	-2	16	72	-2	16	0	-2	16	0	-2	16	0	-2	16	0	-2	16	50	-2	2	-56	-2	2	0	-2	2	50	-2	16	-56	-2	16	0	-2	16	0	-2	16	0	-2	16	0	-2	16	0
-2	16	0	-2	16	0	-2	16	0	-2	16	0	-2	16	18	-2	18	-20	-2	18	118	-2	16	-120	-2	16	0	-2	16	0	-2	16	0	-2	16	0	-2	16	0	-2	16	32	-2	16	36	-2	16	68	-2	16	64	-2	16	0	-2	16	0	-2	16	0	-2	16	0	-2	16	0	-2	16	50	-2	18	-20	-2	18	118	-2	16	-120	-2	16	0	-2	16	0	-2	16	0	-2	16	0	-2	16	50	-2	2	-56	-2	2	0	-2	2	50	-2	16	-56	-2	16	0	-2	16	0	-2	16	0	-2	16	0	-2	16	0
-2	16	0	-2	16	0	-2	16	0	-2	16	0	-2	16	16	-2	16	17	-2	16	-127	-2	16	-128	-2	16	0	-2	16	0	-2	16	0	-2	16	0	-2	16	0	-2	16	34	-2	46	-39	-2	46	-77	-2	16	72	-2	16	0	-2	16	0	-2	16	0	-2	16	0	-2	16	0	-2	16	18	-2	0	-1	-2	16	-119	-2	16	-128	-2	16	0	-2	16	0	-2	16	0	-2	16	0	-2	16	50	-2	2	-56	-2	2	0	-2	2	50	-2	16	-56	-2	16	0	-2	16	0	-2	16	0	-2	16	0	-2	16	0
-2	16	0	-2	16	0	-2	16	0	-2	16	0	-2	16	0	-2	16	0	-2	16	0	-2	16	0	-2	16	0	-2	16	0	-2	16	0	-2	16	0	-2	16	0	-2	16	50	-2	46	-56	-2	46	50	-2	16	-56	-2	16	0	-2	16	0	-2	16	0	-2	16	0	-2	16	0	-2	16	16	-2	16	1	-2	16	-128	-2	16	0	-2	16	0	-2	16	0	-2	16	0	-2	16	0	-2	16	50	-2	2	-56	-2	2	0	-2	2	50	-2	16	-56	-2	16	0	-2	16	0	-2	16	0	-2	16	0	-2	16	0
-2	16	0	-2	16	0	-2	16	0	-2	16	0	-2	16	0	-2	16	0	-2	16	0	-2	16	0	-2	16	0	-2	16	0	-2	16	0	-2	16	32	-2	16	36	-2	16	118	-2	46	-20	-2	46	118	-2	16	-20	-2	16	68	-2	16	64	-2	16	0	-2	16	0	-2	16	0	-2	16	0	-2	16	0	-2	16	0	-2	16	0	-2	16	0	-2	16	0	-2	16	0	-2	16	0	-2	16	50	-2	2	-56	-2	2	0	-2	2	50	-2	16	-56	-2	16	0	-2	16	0	-2	16	0	-2	16	0	-2	16	0
-2	16	0	-2	16	0	-2	16	0	-2	16	0	-2	16	0	-2	16	0	-2	16	0	-2	16	0	-2	16	0	-2	16	0	-2	16	0	-2	16	34	-2	24	-5	-2	27	-39	-2	27	-111	-2	27	-111	-2	27	-77	-2	24	-5	-2	16	72	-2	16	0	-2	16	0	-2	16	0	-2	16	0	-2	16	0	-2	16	0	-2	16	0	-2	16	0	-2	16	0	-2	16	0	-2	16	0	-2	16	50	-2	2	-56	-2	2	0	-2	2	50	-2	16	-56	-2	16	0	-2	16	0	-2	16	0	-2	16	0	-2	16	0
-2	16	0	-2	16	0	-2	16	0	-2	16	0	-2	16	0	-2	16	0	-2	16	0	-2	16	0	-2	16	0	-2	16	0	-2	16	0	-2	16	50	-2	24	-6	-2	27	-56	-2	27	0	-2	27	0	-2	27	50	-2	24	-6	-2	16	-56	-2	16	0	-2	16	0	-2	16	0	-2	16	0	-2	16	0	-2	16	0	-2	16	0	-2	16	0	-2	16	0	-2	16	0	-2	16	0	-2	16	50	-2	2	-56	-2	2	0	-2	2	50	-2	16	-56	-2	16	0	-2	16	0	-2	16	0	-2	16	0	-2	16	0
-2	16	0	-2	16	0	-2	16	0	-2	16	0	-2	16	0	-2	16	0	-2	16	0	-2	16	0	-2	16	0	-2	16	0	-2	16	0	-2	16	50	-2	24	-6	-2	27	-56	-2	27	0	-2	27	0	-2	27	50	-2	24	-6	-2	16	-56	-2	16	0	-2	16	0	-2	16	0	-2	16	0	-2	16	0	-2	16	0	-2	16	0	-2	16	0	-2	16	0	-2	16	0	-2	16	0	-2	16	50	-2	2	-56	-2	2	0	-2	2	50	-2	16	-56	-2	16	0	-2	16	0	-2	16	0	-2	16	0	-2	16	0
-2	16	0	-2	16	0	-2	16	0	-2	16	0	-2	16	0	-2	16	0	-2	16	0	-2	16	0	-2	16	0	-2	16	0	-2	16	0	-2	16	50	-2	24	-6	-2	27	-56	-2	27	0	-2	27	0	-2	27	50	-2	24	-6	-2	16	-56	-2	16	0	-2	16	0	-2	16	0	-2	16	0	-2	16	0	-2	16	0	-2	16	0	-2	16	0	-2	16	0	-2	16	0	-2	16	0	-2	16	50	-2	2	-56	-2	2	0	-2	2	50	-2	16	-56	-2	16	0	-2	16	0	-2	16	0	-2	16	0	-2	16	0
-2	16	0	-2	16	0	-2	16	0	-2	16	0	-2	16	0	-2	16	0	-2	16	0	-2	16	0	-2	16	0	-2	16	0	-2	16	0	-2	16	50	-2	24	-6	-2	27	-56	-2	27	0	-2	27	0	-2	27	50	-2	24	-6	-2	16	-56	-2	16	0	-2	16	0	-2	16	0	-2	16	0	-2	16	0	-2	16	0	-2	16	0	-2	16	0	-2	16	0	-2	16	0	-2	16	0	-2	16	50	-2	2	-56	-2	2	0	-2	2	50	-2	16	-56	-2	16	0	-2	16	0	-2	16	0	-2	16	0	-2	16	0
-2	16	0	-2	16	0	-2	16	0	-2	16	0	-2	16	0	-2	16	0	-2	16	0	-2	16	0	-2	16	0	-2	16	0	-2	16	0	-2	16	50	-2	24	-6	-2	27	-56	-2	27	0	-2	27	0	-2	27	50	-2	24	-6	-2	16	-56	-2	16	0	-2	16	0	-2	16	0	-2	16	0	-2	16	0	-2	16	0	-2	16	0	-2	16	0	-2	16	0	-2	16	0	-2	16	0	-2	16	50	-2	2	-56	-2	2	0	-2	2	50	-2	16	-56	-2	16	0	-2	16	0	-2	16	0	-2	16	0	-2	16	0
-2	16	0	-2	16	0	-2	16	0	-2	16	0	-2	16	0	-2	16	0	-2	16	0	-2	16	0	-2	16	0	-2	16	0	-2	16	0	-2	16	50	-2	24	-6	-2	27	-56	-2	27	0	-2	27	0	-2	27	50	-2	24	-6	-2	16	-56	-2	16	0	-2	16	0	-2	16	0	-2	16	0	-2	16	0	-2	16	0	-2	16	0	-2	16	0	-2	16	0	-2	16	0	-2	16	0	-2	16	50	-2	2	-56	-2	2	0	-2	2	50	-2	16	-56	-2	16	0	-2	16	0	-2	16	0	-2	16	0	-2	16	0
-2	16	0	-2	16	0	-2	16	0	-2	16	0	-2	16	0	-2	16	0	-2	16	0	-2	16	0	-2	16	0	-2	16	0	-2	16	0	-2	16	50	-2	24	-6	-2	27	-56	-2	27	0	-2	27	0	-2	27	50	-2	24	-6	-2	16	-56	-2	16	0	-2	16	0	-2	16	0	-2	16	0	-2	16	0	-2	16	0	-2	16	0	-2	16	0	-2	16	0	-2	16	0	-2	16	0	-2	16	50	-2	2	-56	-2	2	0	-2	2	50	-2	16	-56	-2	16	0	-2	16	0	-2	16	0	-2	16	0	-2	16	0
-2	16	36	-2	16	100	-2	16	100	-2	16	100	-2	16	100	-2	16	100	-2	16	100	-2	16	100	-2	16	100	-2	16	100	-2	16	100	-2	16	118	-2	24	-2	-2	27	-20	-2	27	100	-2	27	100	-2	27	118	-2	24	-2	-2	16	-20	-2	16	100	-2	16	100	-2	16	100	-2	16	100	-2	16	100	-2	16	100	-2	16	100	-2	16	100	-2	16	100	-2	16	100	-2	16	100	-2	16	118	-2	2	-120	-2	2	0	-2	2	50	-2	16	-56	-2	16	0	-2	16	0	-2	16	0	-2	16	0	-2	16	0
-2	2	17	-2	2	-111	-2	2	-111	-2	2	-111	-2	2	-111	-2	2	-111	-2	2	-111	-2	2	-111	-2	2	-111	-2	2	-111	-2	2	-111	-2	2	-111	-2	2	-111	-2	2	-111	-2	2	-111	-2	2	-111	-2	2	-111	-2	2	-111	-2	2	-111	-2	2	-111	-2	2	-111	-2	2	-111	-2	2	-111	-2	2	-111	-2	2	-111	-2	2	-111	-2	2	-111	-2	2	-111	-2	2	-111	-2	2	-111	-2	2	-127	-2	2	-128	-2	2	0	-2	2	50	-2	16	-56	-2	16	0	-2	16	0	-2	16	0	-2	16	0	-2	16	0
-2	2	0	-2	2	0	-2	2	0	-2	2	0	-2	2	0	-2	2	0	-2	2	0	-2	2	0	-2	2	0	-2	2	0	-2	2	0	-2	2	0	-2	2	0	-2	2	0	-2	2	0	-2	2	0	-2	2	0	-2	2	0	-2	2	0	-2	2	0	-2	2	0	-2	2	0	-2	2	0	-2	2	0	-2	2	0	-2	2	0	-2	2	0	-2	2	0	-2	2	0	-2	2	0	-2	2	0	-2	2	0	-2	2	0	-2	2	50	-2	16	-56	-2	16	0	-2	16	0	-2	16	0	-2	16	0	-2	16	0
-2	2	36	-2	2	100	-2	2	100	-2	2	100	-2	2	100	-2	2	100	-2	2	100	-2	2	100	-2	2	100	-2	2	100	-2	2	100	-2	2	100	-2	2	100	-2	2	100	-2	2	100	-2	2	100	-2	2	100	-2	2	100	-2	2	100	-2	2	100	-2	2	100	-2	2	100	-2	2	100	-2	2	100	-2	2	100	-2	2	100	-2	2	100	-2	2	100	-2	2	100	-2	2	100	-2	2	100	-2	2	100	-2	2	100	-2	2	118	-2	16	-120	-2	16	0	-2	16	0	-2	16	0	-2	16	0	-2	16	0
-2	16	17	-2	16	-111	-2	16	-111	-2	16	-111	-2	16	-111	-2	16	-111	-2	16	-111	-2	16	-111	-2	16	-111	-2	16	-111	-2	16	-111	-2	16	-111	-2	16	-79	-2	16	-75	-2	16	-11	-2	16	-11	-2	16	-11	-2	16	-11	-2	16	-11	-2	16	-11	-2	16	-43	-2	16	-47	-2	16	-111	-2	16	-111	-2	16	-111	-2	16	-111	-2	16	-111	-2	16	-111	-2	16	-111	-2	16	-111	-2	16	-111	-2	16	-111	-2	16	-111	-2	16	-127	-2	16	-128	-2	16	0	-2	16	0	-2	16	0	-2	16	0	-2	16	0
-2	16	0	-2	16	0	-2	16	0	-2	16	0	-2	16	0	-2	16	0	-2	16	0	-2	16	0	-2	16	0	-2	16	0	-2	16	0	-2	16	0	-2	16	34	-2	19	-39	-2	19	-111	-2	19	-111	-2	19	-111	-2	19	-111	-2	19	-111	-2	19	-111	-2	19	-77	-2	16	72	-2	16	0	-2	16	0	-2	16	0	-2	16	0	-2	16	0	-2	16	0	-2	16	0	-2	16	0	-2	16	0	-2	16	0	-2	16	0	-2	16	0	-2	16	0	-2	16	0	-2	16	0	-2	16	0	-2	16	0	-2	16	0
-2	16	0	-2	16	0	-2	16	0	-2	16	0	-2	16	0	-2	16	0	-2	16	0	-2	16	0	-2	16	0	-2	16	0	-2	16	0	-2	16	0	-2	16	50	-2	19	-56	-2	19	0	-2	19	0	-2	19	32	-2	19	36	-2	19	68	-2	19	64	-2	19	18	-2	16	-20	-2	16	100	-2	16	100	-2	16	100	-2	16	100	-2	16	100	-2	16	100	-2	16	100	-2	16	100	-2	16	100	-2	16	100	-2	16	68	-2	16	64	-2	16	0	-2	16	0	-2	16	0	-2	16	0	-2	16	0	-2	16	0
-2	16	0	-2	16	0	-2	16	0	-2	16	0	-2	16	0	-2	16	0	-2	16	0	-2	16	0	-2	16	0	-2	16	0	-2	16	0	-2	16	0	-2	16	50	-2	19	-56	-2	19	0	-2	19	0	-2	19	34	-2	16	-39	-2	16	-77	-2	19	72	-2	19	16	-2	19	17	-2	19	-111	-2	19	-111	-2	19	-111	-2	19	-111	-2	19	-111	-2	19	-111	-2	19	-111	-2	19	-111	-2	19	-111	-2	19	-111	-2	19	-77	-2	16	72	-2	16	0	-2	16	0	-2	16	0	-2	16	0	-2	16	0	-2	16	0
-2	16	0	-2	16	0	-2	16	0	-2	16	0	-2	16	0	-2	16	0	-2	16	0	-2	16	0	-2	16	0	-2	16	0	-2	16	0	-2	16	0	-2	16	50	-2	19	-56	-2	19	0	-2	19	0	-2	19	50	-2	16	-56	-2	16	18	-2	19	-20	-2	19	100	-2	19	100	-2	19	100	-2	19	100	-2	19	100	-2	19	100	-2	19	100	-2	19	100	-2	19	100	-2	19	100	-2	19	68	-2	19	64	-2	19	50	-2	16	-56	-2	16	0	-2	16	0	-2	16	0	-2	16	0	-2	16	0	-2	16	0
-2	16	0	-2	16	0	-2	16	0	-2	16	0	-2	16	0	-2	16	0	-2	16	0	-2	16	0	-2	16	0	-2	16	0	-2	16	0	-2	16	0	-2	16	50	-2	19	-56	-2	19	0	-2	19	0	-2	19	50	-2	16	-56	-2	16	16	-2	16	17	-2	16	-111	-2	16	-111	-2	16	-111	-2	16	-111	-2	16	-111	-2	16	-111	-2	16	-111	-2	16	-111	-2	16	-111	-2	16	-111	-2	16	-109	-2	19	108	-2	19	118	-2	16	-120	-2	16	0	-2	16	0	-2	16	32	-2	16	36	-2	16	68	-2	16	64
-2	16	0	-2	16	0	-2	16	0	-2	16	0	-2	16	0	-2	16	0	-2	16	0	-2	16	0	-2	16	0	-2	16	0	-2	16	0	-2	16	0	-2	16	50	-2	19	-56	-2	19	0	-2	19	0	-2	19	50	-2	16	-56	-2	16	0	-2	16	0	-2	16	0	-2	16	0	-2	16	0	-2	16	0	-2	16	0	-2	16	0	-2	16	0	-2	16	0	-2	16	0	-2	16	0	-2	16	48	-2	16	53	-2	16	-27	-2	16	-28	-2	16	100	-2	16	100	-2	16	102	-2	26	-71	-2	26	-73	-2	16	8
-2	16	0	-2	16	0	-2	16	0	-2	16	0	-2	16	0	-2	16	0	-2	16	0	-2	16	0	-2	16	0	-2	16	0	-2	16	0	-2	16	0	-2	16	50	-2	19	-56	-2	19	0	-2	19	0	-2	19	50	-2	16	-56	-2	16	0	-2	16	0	-2	16	0	-2	16	0	-2	16	0	-2	16	0	-2	16	0	-2	16	0	-2	16	0	-2	16	0	-2	16	0	-2	16	0	-2	16	34	-2	26	-39	-2	26	-111	-2	26	-111	-2	26	-111	-2	26	-111	-2	26	-127	-2	26	-94	-2	16	-55	-2	16	-128
-2	16	0	-2	16	0	-2	16	0	-2	16	0	-2	16	0	-2	16	0	-2	16	0	-2	16	0	-2	16	0	-2	16	0	-2	16	0	-2	16	0	-2	16	50	-2	19	-56	-2	19	0	-2	19	0	-2	19	50	-2	16	-56	-2	16	0	-2	16	0	-2	16	0	-2	16	0	-2	16	0	-2	16	0	-2	16	0	-2	16	0	-2	16	0	-2	16	0	-2	16	0	-2	16	0	-2	16	50	-2	26	-56	-2	26	0	-2	26	0	-2	26	0	-2	26	0	-2	26	0	-2	26	18	-2	16	-20	-2	16	68
-2	16	0	-2	16	0	-2	16	0	-2	16	0	-2	16	0	-2	16	0	-2	16	0	-2	16	0	-2	16	0	-2	16	0	-2	16	0	-2	16	0	-2	16	18	-2	19	-120	-2	19	0	-2	19	0	-2	19	18	-2	16	-120	-2	16	0	-2	16	0	-2	16	0	-2	16	0	-2	16	0	-2	16	0	-2	16	0	-2	16	0	-2	16	0	-2	16	0	-2	16	0	-2	16	0	-2	16	18	-2	26	-120	-2	26	0	-2	26	0	-2	26	0	-2	26	0	-2	26	0	-2	26	16	-2	26	17	-2	26	-127
